GGGGGGGGGGGGGGGGGGGG
GGGGGGGGGGGGGGGGGGGG
GGGGFFFFGGGGGGGGGGGG
GGGGFFFFGGGGGGGGGGGG
GGGGGGGGGGGGGGGGGGGG
GGGGGGGGWWWWGGGGGGGG
GGGGGGGGWWWWGGGGGGGG
GGGGGGGGGGGGGGGGGGGG
GGGHHHHGGGGGGGGGGGGG
GGGGGGGGGGGGGGGGGGGG
GGGGGGGGCCCCGGGGGGGG
GGGGGGGGCCCCGGGGGGGG
GGGGGGGGGGGGGGGGGGGG
GGGGGGGGGGGGGGGGGGGG
GGGGGGGGGGGGGGGGGGGG